-99;-99;-99;-99;-99;-99;-99;-99;-99;-99;-99;-99;-99;-99;-99;-99;-99;-99;-99;-99;-99;-99;-99;-99;-99
-99;-99;-99;-99;-99;-99;-99;-99;1;1;1;-99;-99;-99;-99;-99;-99;-99;-99;-99;-99;-99;-99;-99;-99
-99;-99;-99;-99;-99;-99;1;1;1;1;1;1;-99;-99;-99;-99;-99;-99;-99;-99;-99;-99;-99;-99;-99
-99;-99;-99;-99;-99;1;1;1;1;1;1;1;1;-99;-99;-99;-99;-99;-99;-99;-99;-99;-99;-99;-99
-99;-99;-99;-99;1;1;1;1;1;1;1;1;1;1;-99;-99;-99;-99;-99;-99;-99;-99;-99;-99;-99
-99;-99;1;1;1;1;1;1;1;1;1;1;1;1;-99;-99;-99;-99;-99;-99;-99;-99;-99;-99;-99
-99;-99;1;1;1;-99;1;1;1;1;1;1;1;1;1;-99;-99;-99;-99;-99;-99;-99;-99;-99;-99
1;1;1;1;1;-99;1;1;1;1;1;1;1;1;1;-99;-99;-99;-99;-99;-99;-99;-99;-99;-99
1;1;1;1;1;1;1;1;1;1;1;1;1;1;1;-99;-99;-99;-99;-99;-99;-99;-99;-99;-99
1;1;1;1;1;1;1;1;1;1;1;1;1;1;1;-99;-99;-99;-99;-99;-99;-99;-99;-99;-99
1;1;1;1;1;1;1;1;1;1;1;1;1;1;1;-99;-99;-99;-99;-99;-99;-99;-99;-99;-99
1;-99;1;1;1;1;1;1;1;1;1;1;1;1;1;-99;-99;-99;-99;-99;-99;-99;-99;-99;-99
1;1;1;1;1;1;1;1;1;1;1;1;1;1;1;-99;-99;-99;-99;-99;-99;-99;-99;-99;-99
1;1;1;1;1;1;1;1;1;1;1;1;1;1;1;-99;-99;-99;-99;-99;-99;-99;-99;-99;-99
-99;-99;1;1;1;1;1;1;1;1;1;1;1;1;1;1;-99;-99;-99;-99;-99;-99;-99;-99;-99
-99;1;1;1;1;1;1;1;1;1;1;1;1;1;1;1;1;1;-99;-99;-99;-99;-99;-99;-99
1;1;1;1;1;1;1;1;1;1;1;1;1;1;1;1;1;1;1;1;-99;-99;-99;-99;-99
1;-99;-99;-99;1;1;1;1;1;1;1;1;1;1;1;1;1;1;1;1;1;-99;-99;-99;-99
-99;-99;-99;-99;1;1;1;1;1;1;1;1;1;1;1;1;1;1;1;1;1;1;1;1;-99
-99;-99;-99;-99;1;1;1;1;1;1;1;1;1;1;1;1;1;1;1;1;1;1;1;1;-99
-99;-99;-99;1;1;1;1;1;1;1;1;1;1;1;1;1;1;1;1;1;1;1;0;0;-99
-99;-99;-99;1;1;1;1;1;1;1;1;1;1;1;1;1;1;1;1;1;1;1;0;0;-99
-99;-99;1;1;1;1;1;1;1;1;1;1;1;1;1;1;1;1;1;1;1;1;0;0;-99
-99;-99;1;1;1;1;1;1;1;1;1;1;1;1;1;1;1;1;1;1;1;1;0;0;-99
-99;-99;-99;-99;1;1;1;1;1;1;1;1;1;1;0;0;0;0;1;1;1;1;0;0;-99
-99;-99;-99;-99;1;1;1;1;1;1;1;1;1;1;0;0;0;0;1;1;1;1;0;0;-99
-99;-99;-99;-99;-99;1;1;1;1;1;1;1;1;1;1;1;0;0;1;1;1;0;0;0;0
-99;-99;-99;-99;-99;1;1;1;1;1;1;1;1;1;1;1;0;0;1;1;1;0;0;0;0
-99;-99;-99;-99;-99;1;1;1;1;1;1;1;0;0;0;1;1;1;1;1;1;0;0;0;0
-99;-99;-99;-99;-99;-99;1;1;1;1;1;1;0;0;0;1;1;1;1;1;1;0;0;0;0
-99;-99;-99;-99;-99;-99;-99;1;1;1;1;1;0;0;1;1;0;0;0;0;0;0;0;0;0
-99;-99;-99;-99;-99;-99;-99;1;1;1;1;1;0;0;1;1;1;0;0;0;0;0;0;0;0
-99;-99;-99;-99;-99;-99;-99;-99;1;1;0;0;0;0;1;1;1;0;0;0;0;0;0;0;0
-99;-99;-99;-99;-99;-99;-99;-99;1;1;0;0;0;0;1;1;0;0;0;0;0;0;-99;-99;0
-99;-99;-99;-99;-99;-99;-99;-99;0;0;0;0;0;0;1;1;0;0;-99;-99;-99;-99;-99;-99;-99
-99;-99;-99;-99;-99;-99;-99;-99;-99;0;0;0;0;1;1;1;0;0;-99;-99;-99;-99;-99;-99;-99
-99;-99;-99;-99;-99;-99;-99;-99;-99;-99;-99;0;0;1;1;1;0;-99;-99;-99;-99;-99;-99;-99;-99
-99;-99;-99;-99;-99;-99;-99;-99;-99;-99;-99;0;0;1;1;1;0;-99;-99;-99;-99;-99;-99;-99;-99
-99;-99;-99;-99;-99;-99;-99;-99;-99;-99;-99;0;0;1;1;0;0;-99;-99;-99;-99;-99;-99;-99;-99
-99;-99;-99;-99;-99;-99;-99;-99;-99;-99;-99;0;1;1;1;0;0;-99;-99;-99;-99;-99;-99;-99;-99
-99;-99;-99;-99;-99;-99;-99;-99;-99;-99;0;0;1;1;1;0;-99;-99;-99;-99;-99;-99;-99;-99;-99
-99;-99;-99;-99;-99;-99;-99;-99;-99;-99;0;1;1;0;0;-99;-99;-99;-99;-99;-99;-99;-99;-99;-99
-99;-99;-99;-99;-99;-99;-99;-99;-99;-99;0;1;1;0;0;-99;-99;-99;-99;-99;-99;-99;-99;-99;-99
-99;-99;-99;-99;-99;-99;-99;-99;-99;-99;0;0;0;-99;-99;-99;-99;-99;-99;-99;-99;-99;-99;-99;-99
-99;-99;-99;-99;-99;-99;-99;-99;-99;0;1;-99;-99;-99;-99;-99;-99;-99;-99;-99;-99;-99;-99;-99;-99
-99;-99;-99;-99;0;-99;0;0;0;0;1;-99;-99;-99;-99;-99;-99;-99;-99;-99;-99;-99;-99;-99;-99
-99;-99;-99;-99;1;1;0;0;1;1;0;-99;-99;-99;-99;-99;-99;-99;-99;-99;-99;-99;-99;-99;-99
-99;-99;-99;-99;1;1;1;1;1;1;0;-99;-99;-99;-99;-99;-99;-99;-99;-99;-99;-99;-99;-99;-99
-99;-99;-99;-99;0;1;1;1;0;0;-99;-99;-99;-99;-99;-99;-99;-99;-99;-99;-99;-99;-99;-99;-99
-99;-99;-99;-99;0;1;1;1;-99;-99;-99;-99;-99;-99;-99;-99;-99;-99;-99;-99;-99;-99;-99;-99;-99
-99;-99;-99;-99;-99;-99;0;0;-99;-99;-99;-99;-99;-99;-99;-99;-99;-99;-99;-99;-99;-99;-99;-99;-99
-99;-99;-99;-99;-99;-99;-99;-99;-99;-99;-99;-99;-99;-99;-99;-99;-99;-99;-99;-99;-99;-99;-99;-99;-99
